Ek - ایک
Do - دو
Teen - تین
Chaar - چار
Paanch - پانچ
Cheh - چھ
Saat - سات
Aath - آٹھ
Nao - نو
Das - دس
Gyarah - گیارہ
Barah - بارہ
Terah - تیرہ
Chaudah - چودہ
Pandrah - پندرہ
Solah - سولہ
Satrah - سترہ
Atharah - اٹھارہ
Unnees - انیس
Bees - بیس
Ikkees - اکیس
Baees - بائیس
Taees - تئیس
Chobees - چوبیس
Pachees - پچیس
Chhabees - چھبیس
Sattaees - ستائیس
Atthaeis - اٹھائیس
Untees - انتیس
Tees - تیس
